### Abreviation or Acronym
GA = giveaway

fs = for sale

NT = nice try

Tl = time line

FG = fresh graduate

SG = snapgram

PC = photocard

rekber = rekening bersama

ootd = outfit of the day

fw garnier = face wash garnier

cc = credit card

va = virtual account

co = check out

minbel = minimal belanja

nder = sender

WH = ware house

RT = Retweet

rekber = rekening bersama

FUP = fair usage policy 

WM = wall message

OS = official store

CB = cashback

selca = selfie camera

latsol = latihan soal

rl = real life

rp = role player

verval = verifikasi dan validasi

tnc = term and condition

kip = kartu indonesia pintar

dmg = damage bonus

mci = master chef indonesia

pt = pressure test

sjw = social justice warriors

sabi = bisa

fwb = friends with benefits

Menfess” or “Mention and confess

qr = quick response

anw = anyway

salkun = salah akun

sb = subscribe

lrp = left role player

fomo = fear of missing out

ar = adventure rank

jb = join bareng

mentab = mention tab

mv = music videos

mfs = middle finger salute

RE = retained earning

mjb = maaf join bareng

au = alternate universe

fl = friend list

sb = subscribe

joktug = joki tugas

wta = want to ask

bbw = bubble wrap

video fs = video full shot

fyp = for your page

BA = brand ambassador

tilok = titik lokasi
